####################################################################################################
#                                                                                                  #
#                                                                                                  #
#                                                                                                  #
#                                                                                                  #
#                                                                                                  #
#                                                                                                  #
#                                                                                                  #
#                                   *                                                              #
#                                                                                                  #
#                                                                                                  #
#                                                                                                  #
#                                                                                                  #
#                                                                                                  #
#                                                                                                  #
#                                                                                                  #
#                                                                                                  #
#                                                                                                  #
#                                                                                                  #
#                                                                                                  #
#                                                                                                  #
#                                                                                                  #
#                                                                                                  #
#                                                                                                  #
#                                                                                                  #
#                                                                                                  #
#                                                                                                  #
#                                                                                                  #
#                                                                                                  #
#                                                                                                  #
#                                                                                                  #
#                                                                                                  #
#                                                                                                  #
#                                                                                                  #
#                                                                                                  #
#                                                                                                  #
#                                                                                                  #
#                                                                                                  #
#                                                                                                  #
#                                                                                                  #
#                                                                                                  #
#                                                                                                  #
#                                                                                                  #
#                                                                                                  #
#                                                                                                  #
#                                                                                                  #
#                                                                                                  #
#                                                                                                  #
#                                                                                                  #
#####################################################################################################